5 9
##.#.##..
##..#..##
.##.#.#.#
##..##.#.
#..######